.**.....................
...*....................
...*.**.................
***....*................
.......*................
.....***................
........................
........................
........................
........................
........................
........................
.....................***
.....................*..
......................*.
