.***...........***
*..*..........*..*
...*....***......*
...*....*..*.....*
..*....*........*.

