..........*..............................
........*****.................*..........
.......*.....*..............*****........
.......*..**.*.............*.....*.......
...*.***.*.*.**............*.**..*.......
...**....*................**.*.*.***.*...
......**.**....................*....**...
.*****.*.*..*.................**.**......
*......*...*.*..............*..*.*.*****.
**..*****.**.*.............*.*...*......*
............**.............*.**.*****..**
.....**....***.............**............
.....**....***.....**......***....**.....
............**....*..*.....***....**.....
**..*****.**.*.....*.*.....**............
*......*...*.*......*......*.**.*****..**
.*****.*.*..*..............*.*...*......*
......**.**.................*..*.*.*****.
...**....*....................**.**......
...*.***.*.*.**................*....**...
.......*..**.*............**.*.*.***.*...
.......*.....*.............*.**..*.......
........*****..............*.....*.......
..........*.................*****........
..............................*..........
